00 00 00 00 00 00 00 00 00 00 00 00 00 00 00 00 00 00 00 00 00 00 00 00 00 00 00 00
00 00 00 00 00 00 00 00 00 00 00 00 00 00 00 00 00 00 00 00 00 00 00 00 00 00 00 00
00 00 00 00 00 00 00 00 00 00 00 00 00 00 00 00 00 00 00 00 00 00 00 00 00 00 00 00
04 10 10 10 10 10 10 10 10 10 10 10 10 07 05 10 10 10 10 10 10 10 10 10 10 10 10 09
22 33 33 33 33 33 33 33 33 33 33 33 33 11 13 33 33 33 33 33 33 33 33 33 33 33 33 22
22 00 01 02 02 03 33 01 02 02 02 03 33 11 13 33 01 02 02 02 03 33 01 02 02 03 33 22
22 32 11 12 12 13 33 11 12 12 12 13 33 11 13 33 11 12 12 12 13 33 11 12 12 13 32 22
22 33 23 24 24 25 33 23 24 24 24 25 33 23 25 33 23 24 24 24 25 33 23 24 24 25 33 22
22 33 33 33 33 33 33 33 33 33 33 33 33 33 33 33 33 33 33 33 33 33 33 33 33 33 33 22
22 33 01 02 02 03 33 01 03 33 01 02 02 02 02 02 02 03 33 01 03 33 01 02 02 03 33 22
22 33 23 24 24 25 33 11 13 33 23 24 24 21 17 24 24 25 33 11 13 33 23 24 24 25 33 22
22 33 33 33 33 33 33 11 13 33 33 33 33 11 13 33 33 33 33 11 13 33 33 33 33 33 33 22
26 10 10 10 10 09 33 11 28 02 02 03 00 11 13 00 01 02 02 30 13 33 04 10 10 10 10 31
00 00 00 00 00 22 33 11 06 24 24 25 00 23 25 00 23 24 24 08 13 33 22 00 00 00 00 00
00 00 00 00 00 22 33 11 13 00 00 00 00 00 00 00 00 00 00 11 13 33 22 00 00 00 00 00
00 00 00 00 00 22 33 11 13 00 04 10 10 00 00 10 10 09 00 11 13 33 22 00 00 00 00 00
10 10 10 10 10 31 33 23 25 00 22 00 00 00 00 00 00 22 00 23 25 33 26 10 10 10 10 10
00 00 00 00 00 00 33 00 00 00 22 00 00 00 00 00 00 22 00 00 00 33 00 00 00 00 00 00
10 10 10 10 10 09 33 01 03 00 22 00 00 00 00 00 00 22 00 01 03 33 04 10 10 10 10 10
00 00 00 00 00 22 33 11 13 00 26 10 10 10 10 10 10 31 00 11 13 33 22 00 00 00 00 00
00 00 00 00 00 22 33 11 13 00 00 00 00 00 00 00 00 00 00 11 13 33 22 00 00 00 00 00
00 00 00 00 00 22 33 11 13 00 01 02 02 02 02 02 02 03 00 11 13 33 22 00 00 00 00 00
04 10 10 10 10 31 33 23 25 00 23 24 24 21 17 24 24 25 00 23 25 33 26 10 10 10 10 09
22 33 33 33 33 33 33 33 33 33 33 33 33 11 13 33 33 33 33 33 33 33 33 33 33 33 33 22
22 33 01 02 02 03 33 01 02 02 02 03 33 11 13 33 01 02 02 02 03 33 01 02 02 03 33 22
22 33 23 24 21 13 33 23 24 24 24 25 33 23 25 33 23 24 24 24 25 33 11 17 24 25 00 22
22 32 33 33 11 13 33 33 33 33 33 33 33 33 33 33 33 33 33 33 00 33 11 13 00 00 32 22
14 02 03 33 11 13 33 01 03 33 01 02 02 02 02 02 02 03 33 01 03 33 11 13 00 01 02 18
16 24 25 33 23 25 33 11 13 33 23 24 24 21 17 24 24 25 33 11 13 33 23 25 00 23 24 20
22 33 33 33 33 33 33 11 13 33 33 33 33 11 13 33 33 33 33 11 13 33 33 33 33 33 33 22
22 33 01 02 02 02 02 30 28 02 02 03 33 11 13 33 01 02 02 30 28 02 02 02 02 03 33 22
22 33 23 24 24 24 24 24 24 24 24 25 33 23 25 00 23 24 24 24 24 24 24 24 24 25 33 22
22 33 33 33 33 33 33 33 33 33 33 33 33 33 33 33 33 33 33 33 33 33 33 33 33 33 33 22
26 10 10 10 10 10 10 10 10 10 10 10 10 10 10 10 10 10 10 10 10 10 10 10 10 10 10 31
00 00 00 00 00 00 00 00 00 00 00 00 00 00 00 00 00 00 00 00 00 00 00 00 00 00 00 00
00 00 00 00 00 00 00 00 00 00 00 00 00 00 00 00 00 00 00 00 00 00 00 00 00 00 00 00