00 00 00 00 00 00 00 00 00 00 00 00 00 00 00 00 00 00 00 00 00 00 00 00 00 00 00 00
00 00 00 00 00 00 00 00 00 00 00 00 00 00 00 00 00 00 00 00 00 00 00 00 00 00 00 00
00 00 00 00 00 00 00 00 00 00 00 00 00 00 00 00 00 00 00 00 00 00 00 00 00 00 00 00
04 10 10 10 10 10 10 10 10 10 10 10 10 07 05 10 10 10 10 10 10 10 10 10 10 10 10 09
22 00 00 00 00 00 00 00 00 00 00 00 00 11 13 00 00 00 00 00 00 00 00 00 00 00 00 22
22 00 01 02 02 03 00 01 02 02 02 03 00 11 13 00 01 02 02 02 03 00 01 02 02 03 00 22
22 00 11 12 12 13 00 11 12 12 12 13 00 11 13 00 11 12 12 12 13 00 11 12 12 13 00 22
22 00 23 24 24 25 00 23 24 24 24 25 00 23 25 00 23 24 24 24 25 00 23 24 24 25 00 22
22 00 00 00 00 00 00 00 00 00 00 00 00 00 00 00 00 00 00 00 00 00 00 00 00 00 00 22
22 00 01 02 02 03 00 01 03 00 01 02 02 02 02 02 02 03 00 01 03 00 01 02 02 03 00 22
22 00 23 24 24 25 00 11 13 00 23 24 24 21 17 24 24 25 00 11 13 00 23 24 24 25 00 22
22 00 00 00 00 00 00 11 13 00 00 00 00 11 13 00 00 00 00 11 13 00 00 00 00 00 00 22
26 10 10 10 10 09 00 11 28 02 02 03 00 11 13 00 01 02 02 30 13 00 04 10 10 10 10 31
00 00 00 00 00 22 00 11 06 24 24 25 00 23 25 00 23 24 24 08 13 00 22 00 00 00 00 00
00 00 00 00 00 22 00 11 13 00 00 00 00 00 00 00 00 00 00 11 13 00 22 00 00 00 00 00
00 00 00 00 00 22 00 11 13 00 04 10 10 00 00 10 10 09 00 11 13 00 22 00 00 00 00 00
10 10 10 10 10 31 00 23 25 00 22 00 00 00 00 00 00 22 00 23 25 00 26 10 10 10 10 10
00 00 00 00 00 00 00 00 00 00 22 00 00 00 00 00 00 22 00 00 00 00 00 00 00 00 00 00
10 10 10 10 10 09 00 01 03 00 22 00 00 00 00 00 00 22 00 01 03 00 04 10 10 10 10 10
00 00 00 00 00 22 00 11 13 00 26 10 10 10 10 10 10 31 00 11 13 00 22 00 00 00 00 00
00 00 00 00 00 22 00 11 13 00 00 00 00 00 00 00 00 00 00 11 13 00 22 00 00 00 00 00
00 00 00 00 00 22 00 11 13 00 01 02 02 02 02 02 02 03 00 11 13 00 22 00 00 00 00 00
04 10 10 10 10 31 00 23 25 00 23 24 24 21 17 24 24 25 00 23 25 00 26 10 10 10 10 09
22 00 00 00 00 00 00 00 00 00 00 00 00 11 13 00 00 00 00 00 00 00 00 00 00 00 00 22
22 00 01 02 02 03 00 01 02 02 02 03 00 11 13 00 01 02 02 02 03 00 01 02 02 03 00 22
22 00 23 24 21 13 00 23 24 24 24 25 00 23 25 00 23 24 24 24 25 00 11 17 24 25 00 22
22 00 00 00 11 13 00 00 00 00 00 00 00 00 00 00 00 00 00 00 00 00 11 13 00 00 00 22
14 02 03 00 11 13 00 01 03 00 01 02 02 02 02 02 02 03 00 01 03 00 11 13 00 01 02 18
16 24 25 00 23 25 00 11 13 00 23 24 24 21 17 24 24 25 00 11 13 00 23 25 00 23 24 20
22 00 00 00 00 00 00 11 13 00 00 00 00 11 13 00 00 00 00 11 13 00 00 00 00 00 00 22
22 00 01 02 02 02 02 30 28 02 02 03 00 11 13 00 01 02 02 30 28 02 02 02 02 03 00 22
22 00 23 24 24 24 24 24 24 24 24 25 00 23 25 00 23 24 24 24 24 24 24 24 24 25 00 22
22 00 00 00 00 00 00 00 00 00 00 00 00 00 00 00 00 00 00 00 00 00 00 00 00 00 00 22
26 10 10 10 10 10 10 10 10 10 10 10 10 10 10 10 10 10 10 10 10 10 10 10 10 10 10 31
00 00 00 00 00 00 00 00 00 00 00 00 00 00 00 00 00 00 00 00 00 00 00 00 00 00 00 00
00 00 00 00 00 00 00 00 00 00 00 00 00 00 00 00 00 00 00 00 00 00 00 00 00 00 00 00
